CHR_ST,RSID_ST,POS_ST,ALT_ST,REF_ST,CHR_EN,RSID_EN,POS_EN,ALT_EN,REF_EN,PARTITION
19,rs66479618,6499231,T,C,19,rs66479618,6499231,T,C,1
19,rs11672092,6501998,T,C,19,rs11672092,6501998,T,C,1
19,rs11883351,46304400,A,G,19,rs11883351,46304400,A,G,1
19,rs7257103,46306904,T,C,19,rs7257103,46306904,T,C,1
19,rs56309034,46311420,T,C,19,rs56309034,46311420,T,C,1
19,rs12460541,46312077,A,G,19,rs12460541,46312077,A,G,1
19,rs66479618,6499231,T,C,19,rs66479618,6499231,T,C,3
19,rs11672092,6501998,T,C,19,rs11672092,6501998,T,C,3
19,rs66479618,6499231,T,C,19,rs66479618,6499231,T,C,6
19,rs11672092,6501998,T,C,19,rs11672092,6501998,T,C,6
19,rs11672092,6501998,T,C,19,rs11672092,6501998,T,C,11
