CHR,RSID,POS,ALT,REF,PARTITION
18,rs7228414,32634634,A,G,1
18,rs633289,40199690,A,G,1
18,rs7239039,40207586,C,A,1
18,rs8099658,40208205,C,T,1
18,rs10163867,40208272,T,C,1
18,rs8098670,40208385,C,A,1
18,rs7230783,40209557,G,A,1
18,rs7232187,40209612,C,T,1
18,rs9652967,40209893,C,A,1
18,rs9652968,40210301,G,A,1
18,rs3910100,40211122,A,G,1
18,rs3861285,40214391,T,A,1
18,rs714295,40222311,T,A,1
18,rs714298,40222338,G,A,1
18,rs658728,40222856,C,T,1
18,rs8089174,40225585,T,C,1
18,rs9949554,40225586,G,T,1
18,rs8099810,40227508,A,T,1
18,rs626676,40228268,T,C,1
18,rs58137875,40230965,A,G,1
18,rs7236623,40231241,C,A,1
18,rs7236781,40231347,G,A,1
18,rs7234212,40234487,T,C,1
18,rs1346889,40234683,C,T,1
18,rs1346890,40235038,T,C,1
18,rs4263023,40235358,C,G,1
18,rs1430908,40235405,G,T,1
18,rs7359791,40235714,T,C,1
18,rs1835496,40236519,T,C,1
18,rs12456498,40236600,A,G,1
18,rs1835497,40236831,G,T,1
18,rs919563,40237244,T,C,1
18,rs12457128,40237556,T,A,1
18,rs7359732,40237785,C,G,1
18,rs12457214,40237825,G,C,1
18,rs9916901,40238335,G,T,1
18,rs2116100,40238842,T,C,1
18,rs2116101,40238868,C,T,1
18,rs7242107,40239573,G,A,1
18,rs12454144,40240033,C,A,1
18,rs12454146,40240054,G,A,1
18,rs12454214,40240113,A,G,1
18,rs8084332,40240310,G,A,1
18,rs28456360,40240576,T,C,1
18,rs8085891,40240626,C,T,1
18,rs8085016,40240710,T,C,1
18,rs8084914,40240732,G,A,1
18,rs9709512,40240769,A,G,1
18,rs28805389,40241196,G,A,1
18,rs9954750,40241437,G,A,1
18,rs9955013,40241468,A,G,1
18,rs9955046,40241619,T,C,1
18,rs9955047,40241623,T,C,1
18,rs28857851,40242087,A,G,1
18,rs59507773,40242566,A,G,1
18,rs8090385,40243131,T,G,1
18,rs8090578,40243411,T,C,1
18,rs12457745,40243775,A,G,1
18,rs9964714,40244367,A,G,1
18,rs199617330,40244965,C,G,1
18,rs190170649,40245039,A,G,1
18,rs369582338,40245087,C,T,1
18,rs142202809,40245191,G,A,1
18,rs28857338,40245377,G,T,1
18,rs36183165,40246276,A,G,1
18,rs11873011,40246320,G,C,1
18,rs11873040,40246502,T,A,1
18,rs11876227,40246508,G,T,1
18,rs656293,40246537,C,A,1
18,rs8093235,40247001,A,T,1
18,rs8092588,40247101,A,G,1
18,rs8093416,40247141,C,T,1
18,rs8092254,40247151,G,A,1
18,rs8093431,40247193,A,T,1
18,rs8093569,40247240,C,T,1
18,rs12456082,40247910,A,G,1
18,rs12458705,40247945,C,T,1
18,rs9954391,40248349,G,A,1
18,rs4632207,40248511,G,A,1
18,rs8097737,40248555,G,A,1
18,rs8085638,40249400,A,G,1
18,rs8085433,40249522,G,A,1
18,rs1430910,40249816,C,T,1
18,rs1430911,40249832,G,A,1
18,rs1430912,40250236,C,T,1
18,rs9304277,40250404,C,A,1
18,rs9304278,40250616,G,A,1
18,rs9304279,40250762,T,G,1
18,rs9304280,40250774,A,G,1
18,rs9946710,40251014,T,C,1
18,rs1430913,40251279,C,T,1
18,rs12454638,40251789,A,G,1
18,rs9959724,40251857,G,T,1
18,rs9962119,40251944,C,T,1
18,rs4555232,40252375,G,T,1
18,rs1078786,40253155,T,G,1
18,rs752902,40253310,C,T,1
18,rs8096149,40253379,T,C,1
18,rs891566,40254873,T,G,1
18,rs643363,40255166,C,T,1
18,rs9959873,40255279,G,A,1
18,rs8088723,40255491,C,A,1
18,rs9963299,40256209,G,C,1
18,rs2051334,40260235,C,G,1
18,rs9953625,40260494,A,G,1
18,rs9951863,40261607,C,T,1
18,rs2448775,40261616,G,A,1
18,rs9944914,40266471,A,T,1
18,rs9961058,40273285,T,C,1
18,rs10084077,40274426,G,A,1
18,rs635109,40274482,T,A,1
18,rs1430917,40276477,C,T,1
18,rs1430920,40280407,C,T,1
18,rs8086379,40281222,T,G,1
18,rs763931,40282018,G,A,1
18,rs8086502,40288028,G,T,1
18,rs8085804,40288293,T,C,1
18,rs9965523,40292147,C,G,1
18,rs4511622,40295071,C,T,1
18,rs199906980,40295557,C,T,1
18,rs113043622,40296021,C,G,1
18,rs9973172,40299312,G,C,1
18,rs606140,40299425,G,A,1
18,rs3810037,40301641,T,C,1
18,rs3861288,40303754,T,G,1
18,rs12605254,40303789,C,T,1
18,rs3910101,40308748,A,T,1
18,rs12454989,40313140,G,T,1
18,rs13313639,40318077,A,G,1
18,rs10871582,53276589,T,G,1
18,rs590076,53260732,A,G,2
18,rs17514242,53270902,G,C,2
18,rs10871582,53276589,T,G,2
18,rs12458015,53305735,C,T,2
18,rs1031831,53347258,A,C,2
18,rs880423,22236311,C,T,19
18,rs12458118,53276116,T,A,22
18,rs9951280,53276523,G,A,22
18,rs10871582,53276589,T,G,22
18,rs616580,53284109,G,A,22
18,rs1642313,53287570,T,C,22
