CHR,RSID,POS,ALT,REF,PARTITION
18,rs8099658,40208205,C,T,1
18,rs8098670,40208385,C,A,1
18,rs7232187,40209612,C,T,1
18,rs3861285,40214391,T,A,1
18,rs658728,40222856,C,T,1
18,rs626676,40228268,T,C,1
18,rs7236623,40231241,C,A,1
18,rs7236781,40231347,G,A,1
18,rs8093416,40247141,C,T,1
18,rs8085433,40249522,G,A,1
18,rs643363,40255166,C,T,1
18,rs2051334,40260235,C,G,1
18,rs9953625,40260494,A,G,1
18,rs9951863,40261607,C,T,1
18,rs2448775,40261616,G,A,1
18,rs9944914,40266471,A,T,1
18,rs10084077,40274426,G,A,1
18,rs635109,40274482,T,A,1
18,rs1430917,40276477,C,T,1
18,rs1430920,40280407,C,T,1
18,rs8086379,40281222,T,G,1
18,rs763931,40282018,G,A,1
18,rs8086502,40288028,G,T,1
18,rs8085804,40288293,T,C,1
18,rs4511622,40295071,C,T,1
18,rs199906980,40295557,C,T,1
18,rs113043622,40296021,C,G,1
18,rs9973172,40299312,G,C,1
18,rs606140,40299425,G,A,1
18,rs3810037,40301641,T,C,1
18,rs3861288,40303754,T,G,1
18,rs3910101,40308748,A,T,1
18,rs13313639,40318077,A,G,1
